111111111111111111110111m111111
e000000001111111111101110111111
1111111011111111111100000111111
1000001011111111111101111111111
1011101000000000111101111111111
1000101011111110111101111111111
1111100011111110111101111111111
1000101011110000111101111111111
1010000011110110000001111111111
1111111111111110111111111111111